##########..........##########
#        #..........#        #
#        #..........#        #
#        #..........#        #
#        #..........#        #
#        #..........#        #
#        I----------O        #
#        #..........#        #
#        #..........#        #
#        #..........#        #
#        #..........#        #
##########..........##########