##########          ##########
#        #          #        #
#        #          #        #
#        #          #        #
#        #          #        #
#        #          #        #
#        #----------#        #
#        #          #        #
#        #          #        #
#        #          #        #
#        #          #        #
##########          ##########