##########..........##########
#        #..........#        #
#        #..........#        #
#        #..........#        #
#        #..........#        #
#        #..........#        #
#        D----------D        #
#        #..........#        #
#        #..........#        #
#        #..........#        #
#        #..........#        #
##########..........##########