##########          ##########
#        #          #        #
#        #          #        #
#        #          #        #
#        #          #        #
#        #          #        #
#        D----------D        #
#        #          #        #
#        #          #        #
#        #          #        #
#        #          #        #
##########          ##########